NO textures/example_no.webp


SO textures/example_so.webp


WE textures/example_we.webp


EA textures/example_ea.webp


F 9,100,90


C 225,30,25

11111111111111
1000000000001
1000000000001
1000000000001
1000000000001
1000W00000001
1100000000001
10000010000101
10000010000011
100000000001
1000000000001
1111111111111
