NO        textures/GRAY15 16.png

SO textures/GRAY18.png


WE textures/GRAY19.png


EA textures/GRAY22.png
DO textures/GRAY22.png


F 44,49,55


C 26,26,26

11111
10  1
1N001
11111