NO textures/example_no.webp


SO textures/example_so.webp


WE textures/example_we.webp


EA textures/example_ea.webp


F 9,100,90


C 225,30,0

11111111111
  1000000000001
  1000000000001
  1000000000001
  1000000000001
  1000000000001
  1000000000001
100000000000101
10000000000011
100N000000001
1000000000001
1111111111111
