NO textures/blue_tnt.png


SO textures/diamond_block.png


WE textures/calcite.png


EA textures/glass.png


DO textures/iron_door.png


F 185,211,238


C 204,229,255

111111111111111
11100000000000001111
1110011111111111100001111
110001000000C000010110000111
1100111011111111101111111000111
10010001000000000100000001110001
101111101111111110111110100001001
1010000010000000000000001011101011
10101110111110111111111010000010011
1010100000001O100000000011111010001
10101011111111101111111110000011101
101010000000000000000000001110000001
1010101111111111111111111110001111101
10101000000000000000000000000110000001
101011111111111111111111111111101111101
1010000000000000000000000000000001000001
10111111111111111O1111111111111111011111
1000000000000000000000000000000000010001
11C1111111111111111111111111111111111111
10001
10001
10001
10N01
11111