
NO block/green_bottom.png


SO block/crimson_planks_bottom_s.png


WE block/lapis_block_bottom.png


EA block/deepslate_bottom.png


DO block/carved_pumpkin.png


F 25,25,25


C 64,64,128









11
10N1
1111