NO textures/bamboo_block_s.png


SO textures/bamboo_block_top_s.png


WE textures/packed_ice_s.png


EA textures/wet_sponge_s.png



F 238,162,200


C 30,144,255



        1111111111111111111111111        1111111111111111111111111
        1000000000110000000000001        1000000001100000100000001
        1011000001110000000000001        100000N001110000010000001
        1001000000000000000000001        1000000000000000000000001
111111111011000001010000010000001111111111011000111010000010000001
100000000011000001111101111111111000100000000011000001111111111111
11110111111111111100000010001111101111010110110000000100011
11110111111111011101010000001111101111111110110010100000001
11000000110101011110000010000000000001101010111100000100011
10000000100000001100000100011110000000100000001000000100011
10000000000000001101010010001100000000000000011010100100001
11000001110101011111111110011100000111010101111101111001111
11111111110100000000000111111111111111011111000000011010001
1111111111011111111111011           11011111111111111011111
1000000000000000000000001           10000000011000001000001
1011000001110000000000001           11000001110000010000001
100100000000000000000000111111111111001000000000000000000011111111
111111111011000001010000000000001111111111011100001010000010000001
100000000011000001111101111111111100000000011000001111101111111111
111101111111111111000000100011111001111111110111000000101
111101111111110111010100000011111011111111101110101000001
110000001101010111100000100011100000011010101111000001001
100000001000000011000010000000000000010000000110000010001
100000000000000011010100100011000000000000000110101001001
110000011101010111110111100111000001110101011111011110011
111111111111111111111111111111111111111111111111111111111