NO textures/GRAY1516.png

SO textures/GRAY18.png


WE textures/GRAY19.png


EA textures/GRAY22.png


F 44,49,55


C 26,26,26

11111111111111
10000001000001
10010010000001
11000101010101
10000001000001
1001001000N001
11000101000001
10000001000001
10010010000001
11000101000001
10000110110001
10010110100001
11000110100001
10000000000001
11111111111111
