NO textures/GRAY15.png


SO textures/GRAY18.png


WE textures/GRAY19.png


EA textures/GRAY22.png


DO textures/SILVER2R.png


F 44   ,     49    ,    55
C 26    ,   26    ,   26

11111111111111
10000001000001
10010010000001
1100010101C101
10000001000001
1001001000N001
11000101000001
10000001000001
10010010000001
11000101000001
1000011C110001
1001011C100001
1100011C100001
10000000000001
11111111111111
